90 16 12 13
24 510 42 45
32 32
5 15
1 1 1 1 1 1 1 1 1 1 1 1 1 1 1
3 3 4 4 4 4 2 2 2 4 4 4 4 3 3
3 3 4 4 2 2 2 2 2 2 2 4 4 3 3
3 3 4 4 4 4 2 2 2 4 4 4 4 3 3
1 1 1 1 1 1 1 1 1 1 1 1 1 1 1