90 16 12 13
24 510 42 45
32 32
5 15
1 2 1 2 1 2 1 2 1 2 1 2 1 2 1
2 3 2 3 2 3 2 3 2 3 2 3 2 3 2
3 4 3 4 3 4 3 4 3 4 3 4 3 4 3
4 5 4 5 4 5 4 5 4 5 4 5 4 5 4
5 1 5 1 5 1 5 1 5 1 5 1 5 1 5